[Player]
player_x=1
player_y=1
player_d=1

[Map]
##############
#............#
##....######.#
###...#....#.######
###...#....#......#
###.#####.#########
###.......############
###.##################
#....##
#######
